1111111111111
1001000000001
1000010000001
1P0C010000001
111111