11111111111111111111111111
1P011111111111111111111E11
11011111111111111111111011
11000100010000000000100011
11011101110101011110101011
11000000010001010010101011
11110101110011011010001011
11000100000101000010100011
10011111111111111111111011
1C111111111111111111111C11
11111111111111111111111111