
NO textures/north.xpm
SO textures/north.xpm
WE textures/north.xpm
EA textures/north.xpm













F 0,0, 255
C 9, 1, 1















1111111
1000101
1000001
11E1001
1111111