111111
100001
10P001
1C0E01
100001
111111