1111111111111
100100000F001
1000010000001
1PPC010000001
1111111111111