11111111111111111111
1111P000011101010101
1111C0C00C0000000001
111100000000000000E1
11111111111111111111